example1
######
#  o #
# x^ #
#  ###
######